10
-.-.-.G.G.-.-.-.-.-
-.-.-.B.-.G.G.-.-.B
-.-.B.P.B.-.-.-.B.P
-.-.-.B.-.B.-.-.-.B
-.-.B.P.B.P.B.-.-.-
-.-.-.B.-.B.-.-.A.-
-.G.-.-.-.-.B.-.S.-
-.G.-.-.-.B.P.SB.W.S
-.G.-.-.-.-.B.-.S.-
