10
-.-.G.P.PA.-.-.P.-.-
-.-.-.-.-.P.-.-.W.-
-.-.-.-.G.-.-.-.-.-
-.-.G.-.P.W.-.-.P.-
-.-.-.P.-.-.-.P.-.-
-.-.-.-.-.-.-.-.W.-
-.-.-.-.-.-.-.-.P.-
-.-.P.-.-.PW.-.-.-.-
-.P.-.-.-.-.-.W.-.P
W.-.W.-.P.-.-.-.-.-
